                                                                                                            
                                                                                                            
                                                 ░ ░   ▒██                                                  
                                         █████████ █▒   ░  ████████▓                                        
                                    ███     ▓█████ ███ ██  █████░    ████                                   
                                ██░   ███████░   █  ███▒        ███████   ██                                
                             ██   █████       ▒███   █   █ ███        █████  ███                            
                           █▒  ███▓░    ████▓▒   ██             █████     ░███  ██                          
                        ▒█   ███    ██ ▒          █      █            ▓█▒     ███  █▒                       
                      ▒█  ███    ▓░          ░█████ ▓     █████          ███    ███▒ ██                     
                     █  ██▒   ▓█▒        █████    █ ███ █     ▓█████         █     ██░ █░                   
                   █░ ▒██  █ ▒░    ▓ ███ ▒    █   █ █████           ░███      ▒██    ██  █                  
                  █  █       ░    ░█          █ ▒██     █ ██▓          ████      █    ███ █                 
                 █  █    ░▓    ▓██         ████████     ▓ ████████    █    ██     ██    ██ ██               
                   ▓    ▒      █ █    ██████████████░░   ░████████████       ██     █    ██ █               
                 ██ ███            ███████▓▒▓███████████████████▒▓███████      █▓    ██   ██ █              
                 ▓          █      █████ ███████░████████    ▓ ████░▓█████▒     ██    █    ██ █             
                █          █      ████ ████   ████░█████ █████    ████ ▓████     ██    █    █  █            
                             █░  ██ ░▒███  ███ █ ▓░▒ ▒█   █  ░ ██░   ███ ████░ █  ░█    █   ▓█ █▒           
            ▓░▓░               ███░ █▓█ ██▒█     █ ▒ █    █     █ ██  ███▓░███     ██   ██   █░ █           
            █                  ███ ██  ██░ █  ░  █ ▒ █▒   █ ▒▒▒ ░██ ██  ███████     █    █   ██ █           
                              ██  ██ ███ █ █ ░   █ █ █ ██ █ ░▒▒   █ ████ ██▓ ███   █                        
        ██████████████████   ██▒ ██  █▒  █ █  ▓  █ █ █    █     █ █    █  ██████ █▒██████████████████       
          █             ███▓ █████ ▒██   █ █ ▓ █ █ ▓ █▒▒  █ ░ ▒ ▒ █   █▒█  ███▓█  ███             ▓░        
           ████████████▓▓█  ▓█  █▒  █ █ ░█ █     █░▓ ███  █ █   ▒ █     ██▒██ ▒██  ███████████████          
             ░        ███   ██ ▓█ ▓██    █ █ ██░ █▒  ▒█▒▒ █ ▒▒░ ▒ ▒    █░█ ▓██▒██  ████                     
               █████   █ █  ███░█  ███████ ███████▓  ▓█  ░███████▓████████▒▓██▒██  ████  █████              
                       █    █▓  ██                 █░▓███   ▒     ░        ██ ▓██    █                      
             ██████████ █   ▓███▓ ▓▒██▒░░▓█▒▒░█░▓█▓   ▒  █▒▓███▓░ ░█ ░█  ▓  ▓████  ████ ████████            
             ██       ██    ▒█ ██ ▒███████ █▒███  ██ ████▒█ ░░░ █▓█▓▒░░░██░███ ██    ███                    
             ██             ██▒░▓ ▒▓▓    █ █░▒   ██ ▓░▓▒  █░▓  ██ █     █▒  ██▓██     ██                    
              █       ██    ██░█░▓░██   ▓█ █ █   ██  ▒▓▓░ █    ██ █▓█ ▓ ███░█████  █████                    
             ██              █ █ ▓ ██ █ ██ █▒█  ███  ▓█ ▓ █ █░ ██ █ █   ██ ░▓ ░██   ░ █▒                    
             ▒              ██░▓█  ████░██ █ ███ ██ ▓██ █ █ ██░██ █▓ ██ ██░███▓██     █                     
              █             ██ ▓█  █░   ██ █     ██  █▓▒▒ █ █  █▒ █     █▓  █▒░██     █▒                    
              ░          ▓  ████ █ █▓█▒█░█ █ ███░██▒ █  █ █ █ ███ █ █ █ ██▓░▓█████ ████                     
             █               ████  █▓█  ██ █ █   ██  ██ █ █ ██ █▓ █ ▒██ ██░ ██▓█      █                     
             ▓              ░█ █░▓░█▒▓▓ ██ █░ ██ ██  ██   █ ▒█ ██ █ ░█░ ██▒░█▓▓██  █░░█                     
             █▓             ░█ █░  █░ █ ██ █  █░ ██▒█▒█░█ █ █  ██ █▓ ▓  █▓▓██  █      █                     
             █▒             █████ ░██▒█ ██ █▒░█▒ ██  ██ █ █ ██ █▒ █▒ █ ░██ ░████▓   ███                     
             ▒              █▒ ░▓▒ ██▒  ██ █▓▓   ██ ▓ ▓█  █    █▓ █    ░██▒ █  █ █    █                     
             █░             ██ █▓█ █▒ ░ ██ █   ░ ██ ░███  █    ██ █▒ ▓▒ ▓█▒▓█▒██░▓   ██                     
             █              ██▒█▒ ▒███████ ████████ █░██  ███████ ████████░▒█▒ █▓    █▓                     
             ▓           ░█ ██ ██▒▓░       ░      ██▒███░░              ▓░▓░█▓████████▒                     
             █              ██ █        ▓▒▓█▒▒ ░     ▒█ █▓█ ░▓ ▒█░▓▒    ▒   ██▒█                            
             ░              ██ ██ ░███████ █████████▒▒█▒▓░███████▒█████████ █░ █     █                      
             ▓              ██ █▒  █░ ░ ▒█ ██  ░ █▒▓ ██ ▓ █ ░  █▓ █▓   ▒██▒░████     ██                     
             █               █ █▒░ █▓   ██ ██ ▒▒ ██ ░██ █ █    ██ ██░▓ ▒██░░██▒██▒▓███         █            
                            ██░█▒  ██▒▓░██ ██░ ▒ █▒░ ▓█ ▒ █ ▒ ▓██ ██  ▒▓███ ▒█▒█     ██                     
             █              ██ █▓░ █▒ ░ █▓ ██    █▓  ██ ▒ █    ██ ██    █▒▓ ░█▓█     █                      
             █  ▒           █▓ █░  ███████ ████████▓ ▒█ █▓███████░█████████ █▒ █ ░░  █▒                     
             █  ▓░░     ░░  ████░ ░                ▒ ▒█▓▓       ░    ░      ████     █░   ░░                
             █          ░    █ ██  ▓░▓░▒░▒▓▒ ▒░▓▓▒▒  ██ ▒█▓▓▓▓▓██▓█▒░ ▒▒▓█░ █  █    ▓█                      
                        █    █▒██▒▒▓▓▒▒▒░▓▒▒▒▒▒ ▒▒█░ ██░░█▓▓▒▒▒▒  ▒▒▒▓▓▓▒▓▓ ████    █▒                      
                             █▒███████████████████████████▓▓████████████████████  ██                        
                   █▒░ ▒                                                       ▒░████        ░              
           ░     ▓█▒  ░▓                                                            █       ░               
                                                                                                            
                                                                                                            